NAME:
Testmap5

TILES:
ROAD
OFFROAD
GRASS
DESTRUCTION

MAPMATRIX:
000000000000000000000000000000000000000000000000000
011111111100000000444444444444444444411111111111110
011111111100000000555555555555555555511111111111110
011111111111111111444444444100000000000011111111110
011111111111111111444444444100000000000011111111110
011111111111111111444444444100000000000011111111110
011111111111111111444444444100000000000011111111110
011111111111111111444444444100000000000011111111110
011111111111111111444444444100000000000011111111110
011111001111111111444444444444444444400011111111110
011111000111111111555555555555555555500011111111110
011111111111100000000000000000000000000011111111110
011111111111000000000000000000000000000011111111110
011111111111000000000000000000000000000011111111110
011111111111000000000000000000000000000011111111110
011111111111000000000000000000000000000011111111110
011111111111000000000000000000000000000011111111110
011111111111000000000000000000000000000011111111110
011111111111110000000000000000000000000011111111110
011111111111111111444444444444444444400011111111110
011111111111111111444444444444444444400011111111110
011111111111111111111111111111111111111111111111110
011111111111111111111111111111111111111111111111110
011111111111111111111111111111111111111111111111110
011111111111111111111111111111111111111111111111110
000000000000000000000000000000000000000000000000000S

CPMATRIX:
000000000000000000000000000000000000000000000000000
000000000000000000000000000000000000000000000000000
000000000000000000000000000000000000000000000000000
000000000000000000000000000000000000000000000000000
000000000000000000000000000000000000000000000000000
000000000000000000000000000000000000000000000000000
000000000000000000000000000000000000000000000000000
000000000000000000000000000000000000000000000000000
000000000000000000000000000000000000000000000000000
000000000000000000000000000000000000000000000000000
000100000000000000000000000000000000000000000000000
000000000000000000000000000000000000000000000000000
000200000000000000000000000000000000000000000000000
000000000000000000000000000000000000000000000000000
000300000000000000000000000000000000000000000000000
000000000000000000000000000000000000000000000000000
000400000000000000000000000000000000000000000000000
000000000000000000000000000000000000000000000000000
000000000000000000000000000000000000000000000000000
000000000000000000000000000000000000000000000000000
000000000000000000000000000000000000000000000000000
000000000000000000000000000000000000000000000000000
000000000000000000000000000000000000000000000000000
000000000000000000000000000000000000000000000000000
000000000000000000000000000000000000000000000000000
000000000000000000000000000000000000000000000000000S
