NAME:
Map1

TILES:
ROAD
OFFROAD
GRASS
DESTRUCTION

MAPMATRIX:
00000000000000000000000000000000000000000000000000000000000000000000000000000000000000000000000000000
01111111111111111111111111111111111111111111111111001111111111111111111111111111111111111111111111110
01111111111111111111111111111111111111111111111111001111111111111111111111111111111111111111111111110
01111111111111111111111111111111111111111111111111001111111111111111111111111111111111111111111111110
01111110000000000000000000000000000000001111111111001111111111111111111111111111111111111111111111110
01111110000000000000000000000000000000001111111111001111111111111111111111111111111111111111111111110
01111110000000000000000000000000000000001111111111001111111111000000000000000000000000000000011111110
01111110000000000000000000000000000000001111111111001111111111000000000000000000000000000000011111110
01111110000000000000000000000000000000001111111111001111111111001111111111111111111111111111111111110
01111110000000000000000000000000000000001111111111001111111111001111111111111111111111111111111111110
01111111111111100000000000000000000000001111111111001111111111001111111111111111111111111111111111110
01111111111111110000000000000000000000001111111111001111111111001111100000000000000000000000000000000
01111111111111111000000000000000000000001111111111001111111111001111100000000000000000000000000000000
01111111111111111100000000000000000000001111111111001111111111001111111111111111111111111111111111110
01111111111111111100000000000000000000001111111111001111111111001111111111111111111111111111111111110
01111111111111111100000000000000000000001111111111001111111111001111111111111111111111111111111111110
01111111111111111100000000000000000000001111111111001111111111000000000000000000000000000000001111110
01111111111111111100000000000000000000001111111111001111111111000000000000000000000000000000001111110
01111111111111111100000000000000000000001111111111001111111111001111111111111111111111111111001111110
01111111111111111100000000000000000000001111111111001111111111001111111111111111111111111111001111110
01111111111111111100000000000000000000001111111111111111111111001111111111111111000001111111001111110
01111111111111111111111111111111111111001111111111111111111111001111111001111111000001111111001111110
01111111111111111111111111111111111111001111111111111111111111001111111001111111000001111111111111110
01111111111111111111111111111111111111001111111111111111111111001111111001111111000001111111111111110
01111111111111111111111111111111111111001111111111111111111111001111111001111111111111111111111111110
00000000000000000000000000000111111111000000000000000000000000001111111001111111111111111111111111110
00000000000000000000000000000111111111000000000000000000000000001111111001111111111111111111111111110
00000000000000000000000000000111111111000000000000000000000000001111111000000000000000011100000000000
01111111111111111111111111111111111111000000000000000000000000001111111000000001111111111100000000000
01111111111111111111111111111111111111000000000000000000000000001111111111111001111111111100000000000
01111111111000111111111110001111111111000000000000000000000000001111111111111001100000000000000000000
01111111111000111111111110001111111111000000000000000000000000001111111000011111100000000000000000000
01111111111000111111111110001111111111000000000000000000000000001111111000011111100000000000000000000
01111111111111111100011111111111111111000000000000000000000000001111111000000000000000000000000000000
01111110001111111100011111111100011111000000000000000000000000001111111000000000000000000000000000000
01111110001111111100011111111100011111000000000000000000000000001111111111111111111111111111111111110
01111110001111111111111111111100011111000000000000000000000000001111111111111111111111111111111111110
01111111111111111111111111111111111111000000000000000000000000001111111111111111111111111111111111110
01111111111111111111111111111111111111000000000000000000000000001111111111111111111111111111111111110
01111111100000000000000000000000000000000000000000000000000000000000000000000000000000000000011111110
01111111100000000000000000000000000000000000000000000000000000000000000000000000000000000000011111110
01111111111111111111111111111111111111111111111111111111111111111111111111111111111111111111111111110
01111111111111111111111111111111111111111111111111111111111111111111111111111111111111111111111111110
01111111111111111111111111111111111111111111111111111111111111111111111111111111111111111111111111110
01111111111111111111111111111111111111111111111111111111111111111111111111111111111111111111111111110
00000000000000000000000000000000000000000000000000000000000000000000000000000000000000000000000000000S


VEHICLE:
40 x1
42 y1
40 x2
44 y2
180 orientation
9 maxSp
4 maxF
1 m

CHECKPOINT:
1 number_total_height_45
29 x_coordinate_in_tiles
26 y_coordinate_in_tiles
9 width
1 height
CHECKPOINT:
2 number
52 x_coordinate_in_tiles
10 y_coordinate_in_tiles
10 width
1 height
CHECKPOINT:
3 number
94 x
18 y
6 width
1 height
CHECKPOINT:
4 number
52 x
40 y
1 width
5 height

MINE:
2 x
2 y
1 radius
MINE:
76 x
30 y
1 radius
MINE:
25 x
43 y
1 radius
MINE:
25 x
44 y
1 radius
MINE:
25 x
42 y
1 radius
MINE:
20 x
42 y
1 radius
MINE:
20 x
32 y
1 radius
MINE:
20 x
22 y
1 radius