NAME:
Testmap2

TILES:
ROAD
OFFROAD
GRASS
DESTRUCTION

MAPMATRIX:
0000000000000000000000000000000000000000
0111111111111100000000000000000000000000
0111111111111100000000000000000000000000
0111111111111111111111111111100000000000
0000000001111111111111111111100000000000
0000000000000000000111111111100000000000
0000000000000000000111111111100000000000
0000000000000000000111111111100000000000
0111111111111111111111111111100000000000
0111111111111111111111111000000000000000
0111111111111000000000000000000000000000
0111111111111000000000000000000000000000
0111111111111000000000000000000000000000
0111111111111000000000000000000000000000
0111111111111000000000000000000000000000
0111111111111000000000000000000000000000
0111111111111000000000000000000000000000
0000000000000000000000000000000000000000
0000000000000000000000000000000000000000
0000000000000000000000000000000000000000S

CPMATRIX:
0000000000000000000000000000000000000000
0000000000000000000000000000000000000000
0000000000000000000000000000000000000000
0000000000000000000000000000000000000000
0000000000000000000000000000000000000000
0000000000000000000000000000000000000000
0000000000000000000000000000000000000000
0000000000000000000000000000000000000000
0000000000000000000000000000000000000000
0000000000000000000000000000000000000000
0000000000000000000000000000000000000000
0000000000000000000000000000000000000000
0000000000000000000000000000000000000000
0000000000000000000000000000000000000000
0000000000000000000000000000000000000000
0000000000000000000000000000000000000000
0000000000000000000000000000000000000000
0000000000000000000000000000000000000000
0000000000000000000000000000000000000000
0000000000000000000000000000000000000000S
