NAME:
Testmap3

TILES:
ROAD
OFFROAD
GRASS
DESTRUCTION

MAPMATRIX:
000000000000000000000000000000000000000000000000000
011111111111111111111111111111111111111111111111110
011111111111111111111111111111111111111111111111110
011111111111111111111111111111111111111111111111110
011111100000000000000000000000000000000011111111110
011111100000000000000000000000000000000011111111110
011111100000000000000000000000000000000011111111110
011111100000000000000000000000000000000011111111110
011111100000000000000000000000000000000011111111110
011111100000000000000000000000000000000011111111110
011111111111111111000000000000000000000011111111110
011111111111111111000000000000000000000011111111110
011111111111111111000000000000000000000011111111110
011111111111111111000000000000000000000011111111110
011111111111111111000000000000000000000011111111110
011111111111111111000000000000000000000011111111110
011111111111111111000000000000000000000011111111110
011111111111111111000000000000000000000011111111110
011111111111111111000000000000000000000011111111110
011111111111111111000000000000000000000011111111110
011111111111111111000000000000000000000011111111110
011111111111111111111111111111111111111111111111110
011111111111111111111111111111111111111111111111110
011111111111111111111111111111111111111111111111110
011111111111111111111111111111111111111111111111110
000000000000000000000000000000000000000000000000000S

CHECKPOINT:
3 number
1 x_coordinate_in_tiles
5 y_coordinate_in_tiles
6 width
1 height
CHECKPOINT:
2 number
20 x_coordinate_in_tiles
21 y_coordinate_in_tiles
1 width
4 height
CHECKPOINT:
1 number
40 x
10 y
10 width
1 height
CHECKPOINT:
4 number
20 x
1 y
1 width
3 height

MINE:
2 x
2 y
1 radius