NAME:
Map2

TILES:
ROAD
OFFROAD
GRASS
DESTRUCTION

MAPMATRIX:
00000000000000000000000000000000000000000000000000000000000000000000000000000000000000000000000000000
01111111111111111111111111111111111111111111111111111111111111111111111111111110011111111111111111110
01111111111111111111111111111111111111111111111111111111111111111111111111111110011111111111111111110
01111111111111111111111111111111111111111111111111111111111111111111111111111110011110000001111111110
01111111111111111111111111111111111111111111111111111111111111111111111111111110011111000000011111110
01111111100000000000000000000000000000000000000000000000000000000000000011111110011111111110001111110
01111111100000000000000000000000000000000000000000000000000000000000000011111110000111111111000111110
01111111100000000000000000000000000000000000000000000000000000000000000011111110000111111111100011110
01111111111111111111111111111111111111111111111111111111111111111111110011111110011110001111100011110
01111111111111101111011111111111111111111110111111111111111111111111110011111110011110001111100011110
01111101111111111111111111110111111111101111111111011111111100111111110011111111111110001111100011110
01111111101111111111111111111111100011111111101111111111111100111111110011111111111111111111100011110
01111111111111111000111110111111100011111111111111101111111100111111110011111111111111111111100011100
01111110111101111000111111111111100011111011111111111101111100111111110000000000000000000000000011110
01111111111111111000111111111111111111111111111111111111111100111111110000000000000000000000000011110
01111111111111111111111101111110111111111101111111011110000000111111111111111111111111111111110011110
01111111111011111111111111111111111111111111111111111110000000111111111111111111111111111111110011110
00000000000000000000000000000000000000000111111111111110000000111111111111111111111111111111110011110
00000000000000000000000000000000000000000000000000000000000000000000000000000000000000000011110011110
00001111111111111111111111111000000000000000000000000000000000000000000000000000000000000011110011110
00011111111111111111111111111000011111111111111111111111111111111111111111111111111111110011110011110
00111111111111111111111111111000011111111111111111111111111111111111111111111111111111110011110011110
01111111111000000000111111111000011111111111111111111111111111111111111111111111111111110011110011110
01111111110000000001111111111000011111111111111111111111111111111111111111111111111111110011110011110
01111111100111111111111111110000011111111111111111111111111111111111111111111111111111110011110011110
01111111100111111111111111100000011111111100000000000000000000000000000000000000111111110011110011110
01111111100111111111111111000000011111111100000000000000000000000000000000000000111111110011110011110
01111111100111111000000000000000011111111100111111111111111111111111111111111111111111110011110011110
01111111100111111000000000000000011111111100111111111111111111111111111111111111111111110011110011110
01111111100111111001111111111111111111111100111111111111111111111111111111111111111111110011110011110
01111111100111111001111111111111111111111100111111111111111111111111111111111111111111110011110011110
01111111100111111001111110000000000011111100111111100000000000000000000000000000000000000111110011110
01111111100111111001111110000000000011111100111111100000000000000000000000000000000000011111110011110
01111111100111111001111111111111111111111100111111100111111111111111000111111111111100011111110011110
01111111100111111001111111111111111111111100111111100111111111111111000111111111111100011111110011110
01111111100111111001111110000000000011111100111111100111111111111111000111111111111100011111110011110
01111111100111111111111110000000000011111100111111111111111100011111111111110001111111111111110011110
01111111100111111111111111111111111111111100111111111111111100011111111111110001111111111111110011110
01111111100111111111111111111111111111111100111111111111111100011111111111110001111111111111110011110
01111111100000000000000000000000000000000000000000000000000000000000000000000000000000000000000011110
01111111100000000000000000000000000000000000000000000000000000000000000000000000000000000000000011110
01111111111111111111111111111111111111111111111111111111111111111111111111111111111111111111111111110
01111111111111111111111111111111111111111111111111111111111111111111111111111111111111111111111111110
01111111111111111111111111111111111111111111111111111111111111111111111111111111111111111111111111110
01111111111111111111111111111111111111111111111111111111111111111111111111111111111111111111111111110
00000000000000000000000000000000000000000000000000000000000000000000000000000000000000000000000000000S


VEHICLE:
60 x1
42 y1
60 x2
44 y2
180 orientation
15 maxSp
3 maxF
1 m


CHECKPOINT:
1 number
16 x_coordinate_in_tiles
18 y_coordinate_in_tiles
1 width
5 height
CHECKPOINT:
2 number
60 x_coordinate_in_tiles
19 y_coordinate_in_tiles
1 width
6 height
CHECKPOINT:
3 number
30 x
1 y
1 width
5 height
CHECKPOINT:
4 number
75 x
40 y
1 width
5 height


MINE:
2 x
2 y
1 radius
MINE:
27 x
33 y
1 radius
MINE:
83 x
9 y
1 radius
MINE:
21 x
21 y
1 radius
MINE:
98 x:
2 y:
1 radius
MINE:
70 x
36 y
1 radius
MINE:
75 x:
38 y:
1 radius