NAME:
Testmap

TILES:
ROAD
OFFROAD
GRASS
DESTRUCTION

MAPMATRIX:
0000000000000000000000000000000000000000
0000001000100000000444444444444444444400
0000001000100000000555555555555555555500
0001000000000100000400000000100000000000
0000111111111000000400000000100000000000
0000000000000000000400000000100000000000
0000000000000000000400000000100000000000
0000000000000000000400000000100000000000
0000000000000000000400000000100000000000
0000001000100000000444444444444444444400
0000001000100000000555555555555555555500
0001000000000100000000000000000000000000
0000111111111000000000000000000000000000
0000000000000000000000000000000000000000
0000000000000000000000000000000000000000
0000000000000000000000000000000000000000
0000111111111000000000000000000000000000
0000000000000000000000000000000000000000
0000000000000000000000000000000000000000
0000000000000000000000000000000000000000S

CPMATRIX:
0000000000000000000000000000000000000000
0000000000000000000000000000000000000000
0000000000000000000000000000000000000000
0000000000000000000000000000000000000000
0000000000000000000000000000000000000000
0000000000000000000000000000000000000000
0000000000000000000000000000000000000000
0000000000000000000000000000000000000000
0000000000000000000000000000000000000000
0000000000000000000000000000000000000000
0000000000000000000000000000000000000000
0000000000000000000000000000000000000000
0000000000000000000000000000000000000000
0000000000000000000000000000000000000000
0000000000000000000000000000000000000000
0000000000000000000000000000000000000000
0000000000000000000000000000000000000000
0000000000000000000000000000000000000000
0000000000000000000000000000000000000000
0000000000000000000000000000000000000000S
